3 Crowns Technologies: 3ctech.com.au
5 Elk: elkjop.no
6clicks: clicksud.biz
37South: southwest.com
A. S. White: aswhiteglobal.com
Access Community Services: accesscommunity.ca
AccountKit: account-kit.com
Access4: accessibe.com
Acurus: acurussolutions.com
Acumen Data: acumendata.io
Activ8 Technologies: activtech.com
ACT LOGISTICS: act-logistics.co.za
ACT-XM: actxm.com
Accurri: accurri.com
Aerofiler: aerofiler.com
Advara: varaosamaailma.fi
Advent One: adventone.com
AfterDark Technology: adit.net.au
AGI TM: agit.com.mx
AG Security Group: agsecurity.com.au
Agile Analytics: agile-analytics.com.au
Agrival: agrivaluechain.com
AIIP: aiipmr.gov.in
Airlock Digital: airlockdigital.com
Airteam: airteamimages.com
Aiculus: aiculus.co
AKIPS: akips.com
Alcolizer: alcolizer.com
Alex Solutions: alexsolutions.com
Allens: allenscamera.com
Aliva: alivape.com
Allmain: allmaincluser.com.br
AMES Australia: ames.net.au
AMOG: amobyng.com.ng
Amplify-Now: amplify-now.com
AngusKnight: angusknight.com.au
ANROS GROUP: anrosgroup.com
TOFRUM  ": tofrum.com
TOFRUM  ": tofrum.com
APNIC: apnic.net
April9 Digital Consulting: april9.com.au
APROMORE: apromore.com
Aqura Technologies: aqura.com.au
Arctic Intelligence: arctic-intelligence.com
ARL Collect: arlcollect.com.au
Argos.io: argos-io.com
Askable: askable.com
Askable: askable.com
Aspire 42: aspireship.com
Aspire 42: aspireship.com
Asset Vision: assetvision.com.au
AssetFuture: assetfuture.com
Asuria: asuria.com.au
Atmail: atmail.com
Atosa: atosa.asia
Ausgrid: ausgrid.com.au
Austal: austal.com
Australian Group Insurances: agigroup.com.au
Australian Institute of Company Directors: aicd.com.au
Australian Moneymarket: moneymarket.com.au
Automic: automicgold.com
Australian Valuers: australianvaluers.com.au
Avivo: Live Life: avivo.org.au
Avinet: avinetworks.com
Auxilis: auxilis.com
AZZO: azzouzhouse.com
BAI Communications: baicommunications.com
BAI Communications: baicommunications.com
Bamara: bamarang.co.uk
Bay Technologies: baytech.com.au
Bartier Perry: bartier.com.au
Base2Services: base2services.com
Beakon: beakon.io
Beamible: beamible.com
Billigence: billigence.com
BIRDI: birdies.com
Bixelab: bixelab.com
Biza: bizapedia.com
BizCubed: bizcubed.com.au
BIZLINK Inc: bizlink.asn.au
Black Innovation 2: blackinnovationalliance.com
Betfair: betfair.com
Blak Box: blakboxxradio.com
Bluerydge: bluerydge.com
BlueShield Technologies: blueshield.com.au
Bluestone Group: bluestone-group.com
Bluewater Control: bluewatercontrol.com
Boardroom: boardroom.tv
Bookipi: bookipi.com
Brace168: braceletbook.com
Bravure: bravure.com.au
Brazier Motti: braziermotti.com.au
Brennan IT: brennanit.com.au
Brevity: brevity.com.au
BPO Intelligence: bpointelligence.com
BSA Limited: bsa.com.au
BrilliantFit: brilliantfit.co
Building Services Consulting Australia: bscaustralia.com.au
Built: builtin.com
Burgess Rawson: burgessrawson.com.au
Business Automation Works: businessautomationworks.com.au
Business Automation Works: businessautomationworks.com.au
Business Fitness: businessfitness.biz
Buy Link: buylink.pro
C.P.M Australia: cpm-aus.com.au
Cabrini Technology Group: cabrini.technology
Caledonia Group: caledoniagroup.it
Calytrix Technologies: calytrix.com
Cancer Institute NSW: breastscreen.nsw.gov.au
CancerAid: cancerarfoundation.org
Canon Australia: canon.com.au
Capital Guardians: capitalguardians.com
Care Access: careaccess.com
CareMonitor: caremonitor.com.au
Canva: canva.com
Cashflow Manager: cashflow-manager.com.au
Catalyser: catalyseresearch.com
Centennial Coal: centennialcoal.com.au
Ceres Tag: cerestag.com
Careview: care-view.com
CFS Australasia: cfs-australasia.com
CHANGEPLAN: changeplan.co
ChangePlan: changeplan.co
Charter Keck Cramer: charterkc.com.au
Chemwatch: chemwatch.net
Claim Central Consolidated: claimcentral.com.au
Clayton Utz: claytonutz.com
Clearbox Systems: clearboxsystems.com.au
Cloudwerx: cloudwerx.tech
Code House: codehouse.com.au
Codify: codifylab.com
Cogito Group: cogitogroup.net
Commit Works: commit.works
Cloud Raptor: cloud-raptor.com
CommTel Network Solutions: commtelns.com
Compass Education: compassprep.com
Complexica: complexica.com
Comply Flow: complyflow.com
Complii FinTech Solutions: complii.com.au
Conexxia: conexxia.com
Connect Source: connectscg.com
Compumedics: compumedics.com.au
Connexion Telematics: connexionmobility.com
Connley Walker: connleywalker.com.au
Content Security: contentsecurity.com.au
Contivio: contivio.com
Cordel: cordeliacruises.com
contactSPACE: contactspace.com
Core Practice: corepractice.com.au
COREIOT: coreiot.fi
CorpCloud: corpcloud.com.au
Corporate Governance Risk: corpgovrisk.com
Coral Active: coralactive.com
Covaler: covaler.com
Coverforce: coverforce.com.au
Cranbrook School: cranbrook.nsw.edu.au
Creativa: creativabox.com
Credit Clear: creditclear.com.au
Creditor Watch: creditorwatch.com.au
Criteria Corp: criteriacorp.com
Criticalarc: criticalarc.com
CSO Group: csogroup.com.au
Cube Networks: cubenetworks.com.au
cubesys: cubesystems.lv
CTARS: ctars.com.au
Curious Thing: curiousthing.io
Customer Consulting Group: customerconsulting.com.au
Customer Science: customersciencelab.com
Customology: customology.com.au
CyberCX: cybercx.com
CYBERSTASH: cyberstash.com
Cydarm Technologies: cydarm.com
Cybertechpro: cybertechprojects.com
DalRae Solutions: dalraesolutions.com
Data Capture Experts: datacaptureexperts.com.au
Curtin University: curtin.edu.au
Data Tools: datatools.com.au
Data Zoo: datazoo.com
Datalink Internet Systems: datalink.com.au
Datix: datixinc.com
DC Alliance: dcalliance.com.au
DDLS: ddl.it
DC TWO LIMITED: dctwo.com.au
de.iterate: deiterate.com.au
Decipha: decipha.com.au
dereOida: dereoida.com
Dialog: dialog.lk
Digicall Assist: digicallassist.com.au
Digital Agriculture Services: digitalagricultureservices.com
Digital Disruption Solutions: digitaldisruptionsolutions.com
Division 5: divisiond.com
DUG Technology: dug.com
Duons: duons.jp
Dynamiq: dynamique-mag.com
Dye & Durham: dyedurham.com
Edge Centres: edgecentres.com
eHealth NSW: ehealth.nsw.gov.au
Elite Print Solutions: eliteprintsolutions.com.au
Elula Group: elulagroup.co.za
Ellipsis & Company: ellipsis.company
Elysium Digital: elys.com
Emantra: e-mantra.in
Enablo: enablo.com
Energetics: phyto5.us
Enex: enexor.com
Enablis: enablis.org
Engage: en-gage.net
Envirolab Group: envirolab.com.au
Entsia: entsia.com
Engagis: engagis.com
Enviropacific: enviropacific.com.au
EPL Group: epl.in
e-PayDay: freepay.com.au
eSignatures.io: esignatures.io
Esri Australia: esriaustralia.com.au
ESSAI: essain.fr
Ethan Group: execonline.it
e-Tools Software: e-tools.com.au
eTool: etools.bg
Evergen: evergent.com
Etax Accountants: etaxaccountants.in
Evologic: evologics.de
Evolution Systems: evolutionsystems.com.au
Extrack: extrack.com
Field Solutions Group: fieldsolutions-group.com
Fireant: fireant.vn
Financial Spectra: financialspectra.com
Fire Forensics: fireforensics.com.au
Firmus: firmus.com.sg
Five Rings Aerospace: 5r.net.au
Fixus Technologies: fixus.com.au
Flare HR: flarehr.com
Fluger: tandemfliegen.aero
FM Clarity: fmclarity.com
Force IT: forceit.com.au
Focus Networks: focusnetworkservices.com
Forrest Personnel: fp.org.au
Fortiro: fortiro.com
foundU: foundu.com.au
Four Nines: fournines.co.jp
Fraser Valuers: fraservaluers.com
Fred IT Group: fred.com.au
FuseWorks: fuse.work
Fusion Digital: fusiondigitalmarketing.com
Future Data Sense Technologies: fedasen.com.au
G1 Asset Management: g1.com.au
Galaxy City: hotelgalaxythassos.gr
Gaia Resources: gaiaresources.com.au
Fusion5: fusion.net
Genie Solutions: geniesolutionssoftware.com.au
Gilchrist Connell: gclegal.com.au
Global Data: globaldata.com
Global IT Factory: globalitfactory.com
GLX Digital: glxdigital.com
Goalhub: goalhub.com
Good Human: goodhumancampaign.com
Good2Give: good2give.ngo
Govote: govote.org
Gratex International AUST: gratex.com.au
GPA Engineering: gpaeng.com.au
Greenbox Group: greenboxgroupsg.com
Guardtech: guardtecsecurity.com
Healthengine: healthengine.com.au
Hansen Corporation: hansen-motor.com
Help Enterprises: helpemployment.com.au
HiCom Care: hicomcare.com.au
Hitech Support: hitechsupports.com
Home Loan Experts: homeloanexperts.com.au
Honey Insurance: honeyinsurance.com
Horrigan Kamitsis Valuers: hkv.com.au
"Hospital Products Australia: hpaust.com
Wamee  ": wameed.co
Hosted Network: hostednetwork.com.au
Howatson+Co: howatsonco.com.au
Hotline IT: hotlineit.com
Humanetix: humanetix.com.au
Huon IT: huonit.com.au
Hyperion Technology: hyperiontg.com
HWL Ebsworth Lawyers: hwlebsworth.com.au
i3Group: i2group.com
iasset.com: iasset.com
ibCom: ibcomics.com
iCognition: icognition.com.au
icourts: icourts.com.au
i-Link Research Solutions: i-linkresearch.com
Immediation: immediation.com
IMMIJ: immijob.com
Impact Services: impact-services.co.uk
Inauro: inauro.io
IND Technology: ind-technology.com.au
Indue: indue.com.au
Info Tech Consulting: infotech-inc.com
Infomedia: infomedia.co.id
InfoMedix: infomedix.com.au
InfoSecAssure: infosecassure.com.au
InfoTrack: infotrack.com
Ingenuous: ingenuous.co.uk
Infoxchange: infoxchange.org
Information Alignment: inapl.com
INFORMED 365: informedk12.com
InLoop: inloop.network
Innovation Group (Australia): innovation-group.au
Insicon: insicon.se
Insentra: insentragroup.com
Inspectivity: inspectivity.com
insightfactory.ai: insightfactory.ai
Insight Mercantile: insightmercantile.com
IntelliTek: intellitek.com.au
Interactive: interactivebrokers.com
Intergy Consulting: intergy.com.au
Inventorium: inventorium.com.au
IODM: iodm.com.au
IP.Glass: ip.glass
IPN Valuers: ipnvaluers.com.au
IPRO Group: iprogroup.ca
Ipsos: ipsosisay.com
IPTel Solutions: iptel.com.au
IQX Business Solutions: iqxbusiness.com
iseek: iseekplant.com.au
IRE: ireceptar.cz
IT Alliance Australia: italliance.com.au
ISOPro: isopromat.ru
IT Basecamp: itbasecamp.com.au
IT Vision: itvision.ie
iyarn: iyarn.com
iTrazo TraceTech: itrazotracetech.com
Jemini: jeminiprotectiveservices.com
Jobs Australia Enterprises: jobsaustralia.com.au
John Virtue Valuers: johnvirtuevaluers.com.au
Kaplan Professional: kaplanprofessional.com
Kinetic IT: kineticit.com.au
KINSHIP digital: kinshipdigital.com
KordaMentha: kordamentha.com
Kraken Coding: krakencoding.com
LAB3: labcorp.com
LANDCOM: land.com
Last Yard: lastyard.com
Law Enforcement Conduct Commission: lecc.nsw.gov.au
Lawcadia: lawcadia.com
Law In Order: lawinorder.com.au
Linktech Australia: linktechaustralia.com.au
Live Crowd: livecrowd.com
Lodestone Solutions: lodestonesolutions.com.au
Lodge iT: lodgeit.net.au
Logbook Me: logbookmemories.com
Lubrication Engineering: lubeng.com.au
Lumary: lumary.com
Lucidity Software: luciditysoftware.co.uk
Macquarie Telecom: macquarietelecom.com
Macquarie Telecom: macquarietelecom.com
Maddocks: maddocks.com.au
Mailguard: mg.co.za
MADEC Australia: madec.edu.au
Mandalay Technologies: mandalaytech.com.au
MANGANO IT: manganoit.com.au
Marketplacer: marketplacer.com
Marine Plant Systems: marineplantsystems.com
Matrix Solutions: matrixformedia.com
Max ID: maxidom.ru
Maxsum Consulting: maxsum.com
MediaHub Australia: mediahubaustralia.com.au
Medical Objects: medicalobjects.com
Medihost Solutions: medihostsolutions.com.au
MEGT (Australia): megt.com.au
McNair yellowSquares: mcnairyellowsquares.com.au
Melbourne Cricket Club: mcc.org.au
Melbourne Mailing: melmailing.com.au
"Memko: memko.com.au
Memko Systems  ": memkosystems.in
Meridian IT (Australia): meridianit.com.au
Message4U: message.us
MessageXchange: messagexchange.com
Metro Trains Australia: metrotrainsau.com
Microkeeper: microkeeper.com.au
Micron21: micron.com
Modeus: modeus.co
Momentum Cloud: momentumcloud.com.au
Moray & Agnew: moray.com.au
Moresol: deservesmore.com
Morgan Project Services Australia: morganprojects.net.au
Morris Cohen Glen & Co: morco.com.au
MSP Blueshift: mspblueshift.com.au
Mumba: mumbailive.com
m-View Live Video: mview.com.au
My Plan Manager.com.au: myplanmanager.com.au
My Workplace Health: myworkplacehealth.com
MyEmpire Group: myempire.group
Myprosperity: myprosperity.com.au
Myriota: myriota.com
National Technical Services: ntsaustralia.com.au
Navigo: navigossearch.com
Navitas Skilled Futures: navitas-skilled-futures.com.au
"NEC Australia: nec.com.au
(ABN 86 001 217 527)": abnamro.nl
NET360: netflix.com
netBI: netbilling.com
Netier: netier.com.au
Netfront: dotnet-frontend.com
Netregistry: sandscivilgroup.com.au
NETSIGHT: net-sight.com
Network Solutions Group: netsg.co
Nexon Asia Pacific: nexon.com.au
NEXION Networks: nexionnetworks.com
Nexon Asia Pacific: nexon.com.au
Nodifi: nodifi.com.au
Nordwake: nordwake.com.au
Nova Systems: nova-se.com
NostraData: nostradata.com.au
NSW Education Standards Authority: educationstandards.nsw.edu.au
Nuago: nuago.com.au
NW Computing: nwcomputing.com.au
Oban: o-bank.com
Oberix Group: oberix.com
OCA Group: ocagroup.com
OccuMED: occumedclinic.ae
Oceanic Consultants: oceanicconsultants.com
OCTEC Limited: octec.org.au
OLINQUA: olinqua.com
OMC International: omcinternational.com
Omnix: omnix.com
ONDA GROUP: ondagroup.com.au
OneTeam IT: oneteam.it
Onugo: onugo.com
Optimatics: optimatics.es
Oqea: oqea.com
Order2Invoice: order2invoice.com
Orima Research: orima.com.au
ORRO Group: orro.group
Our Community: ourcommunitynow.com
Outcomex: outcomex.com.au
Outposter: outposter.com.au
PaperCut Software: papercut.com
Pacific Solutions: pacific-solutions.com
Payroll Metrics: payrollmetrics.com.au
PAYPAC Payroll Services: paypac.com.au
PaysOnline: paysonline.com.au
Panthera Finance: pantherafinance.com.au
PD Training: pdtraining.com.au
PenCS: pencs.com.au
Pending AI: pending.ai
People Diagnostix: peoplediagnostix.com.au
Performance Leader: performanceleaders.biz
Permaconn: permaconn.com
Personify Care: personifycare.com
PhoenixDX: phoenix-dx.com
Pinnacle Rehab: pinnaclerehab.com.au
Pinnacle Rehab: pinnaclerehab.com.au
Pintech: pintechnologies.mx
Plate Impressions: plateimpressions.com.au
Plexus: plexusworldwide.com
Pluss Communities: plusscommunities.com
Polonious: polonious-systems.com
Praxis Aerospace: praxisaerospace.com.au
Precision IT: precisionit.com.au
Precision Technic Defence: ptdefence.com
Premier Contact Point: premiercontactpoint.com
Preston Rowe Paterson: prpnz.nz
Prime Ecosystem: primeecosystem.com.au
Profectus Group: profectus.group
Propel Ventures: propelventures.com.au
PSQ Group: psqgroup.com.au
quality.com.au: quality.com.au
Quantium: quantiumsolutions.com
Queensland Police Service: mypolice.qld.gov.au
Quo Group: quogroup.com
Rapid Global: rapidglobal.com
Rapid Map Global: rapidmap.global
RapidID: rapidid.com
Quality Trade: qts.com.ec
ReadyTech: readytech.com
Red Marker: redmarker.io
Redbook Inspect: redbookinspect.com.au
RedEye Apps: redeye.co
Redfrost: redfrost.com.au
Reejig: reejig.com
Rely Platform: relyplatform.com
Resonate Solutions: resonate.cx
Results Direct: resultsdirect.com
ResearchMaster: researchmasterminds.com
Revium: revium.com.au
RightShip: rightship.com
Reserve Bank of Australia: rba.gov.au
Rockwell Information Services: rockinfo.com
Rokt: rokt.com
Safe Ag Systems: safeagsystems.com
Salary Packaging Australia: salpacaus.com.au
Sarah Constructions: sarah.com.au
Scalene Group: scalene.group
Scantek Solutions: scanteksl.com
Schools Industry Partnership: schoolsindustry.com.au
Scope Systems: scopesystems.com.au
Second Skin: secondskinaudio.com
ScribeFire: scribefire.com
Secure Agility: secureagility.com
Secure Forte: secureforte.com.au
Securecy: securecyberdefense.com
Securitas Australia: securitas-australia.com.au
Seamless SMSF: seamless-smsf.com.au
Seeing Machines: seeingmachines.com
Sentient Hubs: sentient-hubs.com
Sentral: sentral.com.au
Security Shift Group: securityshift.com
Sentrian: sentrian.com.au
Service NSW: service.nsw.gov.au
SecureCo: securecommunitynetwork.org
Shield Corporate Security: shieldcorporatesecurity.com
Shred-X: shred-x.com.au
Shipeezi: shipeezi.com
Shred-X: shred-x.com.au
SILVERHORSE TECHNOLOGIES: silverhorsetech.com
Silverpond: highlighter.ai
Simple Machines: simplemachines.org
Simpology: simpology.com.au
SiSU Wellness: sisuwellness.com.au
SiteMinder: siteminder.com
Sixty Digits: sixtydigits.com
Skyjed: skyjed.com
Skyzer: skyzero.sky
Skyzer: skyzero.sky
Slyp: slypn.org.uk
SMETEC Services: smetecservices.com.au
Smile IT: smileitsolutions.com
smrtr: smrtrcms.com
SMYL: smyl.es
Social Planet: socialplanet.in
Software North: softwarenorth.com
Solutionary Health: solutionaryhealth.com.au
SolutionOne: solutiononemaritime.com
SpendConsole: spendconsole.ai
ST Consulting: 1st.consulting
Star International: stargroupindia.com
State Mercantile: statemercantile.com.au
STEPS Group Australia: stepsgroup.com.au
Strong Room AI: strongroom.ai
Subnet: subnetservices.com
Suncorp Group: suncorpgroup.com.au
Sunwater: sunwater.com.au
SuperChoice Services: superchoiceservices.com
SUPERED: supereduc.cl
SWOOP Analytics: swoopanalytics.com
Swyftx: swyftx.com
Sydney Multicultural Community Services: sydneymcs.org.au
SYC: sycuan.com
Sydwest Multicultural Services: sydwestms.org.au
Syncfish: syncfish.com.au
Synertec: synertech-us.com
Synchro Marketing Australia: synchro.com.au
SYNTRIC: syntricate.com.au
Taguchi Marketing: taguchi.com.au
Tactive: tactivesoft.com
SysCare IT Solutions: syscare.com.au
TALaw: talawagames.com
Taylor Fry: taylorfry.com.au
Team Thrive: teamthrivelending.com
Talent First AI: talentfirst.ai
TECHENVY: techenvy.com.au
TekNet: teknetatili.com
TeleResult: teleresults.com
The Alpha School System: tassweb.com.au
The Career Insight Group: thecareerinsightgroup.com
The Pistol: thepistolpad.com
The Red Fox Group: theredfoxgroup.com.au
thelawstore.com.au: thelawstore.com.au
Thesoco: thesocorrofoundation.org
Thomson Geer: tglaw.com.au
ThreatDefence: threatdefence.com
Tickit Systems: tickitsystems.com.au
Tikabu: tikabu.com.au
Titanium Digital: titanium.com.au
TLC Aged Care: tlcsunlight.com.au
TM Stagetec Systems: tm-systems.com.au
Thompson Cooper Lawyers: tclawyers.com.au
Torque Software: torque.software
Toustone: toustone.com
Track Protection Australia: trackprotection.com.au
TR3 Recruitment: tr3recruitment.com.au
TRANSDEV AUSTRALASIA: transdev.com.au
Transport for NSW: transport.nsw.gov.au
Transportme: transportmedia.co.uk
TreeServe: treeserve.com.au
Trellian: trellian.com
Trellis Data: trellisdata.com
Triskele Labs: triskelelabs.com
Tritium: tritiumpartners.com
Truis: truist.com
Turbid: turbidite.com
Ultimate Security Australia: ultimatesecurity.com.au
UNIFY Solutions: unifysolutions.net
UNIVERSAL COMMUNICATIONS GROUP: ucg.co.nz
University of Melbourne: ummss.org.au
Unleash Live: unleashlive.com
UPowr: upowr.com
VA Platinum: vaplatinum.com.au
VALAI: valaitamil.com
Valiant Press: valiantpress.com.au
Vertex Technologies: vertextechnology.com
Vertex Technologies: vertextechnology.com
Vervoe: vervoe.com
Vescient: vescient.com
Victorian Chamber of Commerce and Industry: victorianchamber.com.au
Vinci Software: vincisoftware.com
Viden Consulting Group: videnconsulting.group
Vision 6: vgsi.com
VisitUs Reception: visit-us.com
Visual Cortex: visualcortex.com
Visual Data Solutions: visualdatasolutions.com
Vokke: vokke.com.au
VTan Consulting: vtanconsulting.com
Vudoo: vudoo.com
Wageloch: wageloch.com.au
WageSafe: wagesafe.com.au
Walsh & Monaghan: wmval.com.au
WCIG: wci-gc.com
WCIG: wci-gc.com
WebCentral: webcentral.au
WBP Group: wbpgroup.com.au
Wesley Mission Queensland: wmq.org.au
Westfund: westfund.com.au
WISE Employment: wiseemployment.com.au
WISE Employment: wiseemployment.com.au
Wolk Technology: wolk.com.au
Wolters Kluwer Australia: wolterskluwerworkforus.com
Working Mouse: workingmouse.com.au
Worklabs: worklabs.com
WorldLearn: worldlearning.org
Wrkr: wrkr.com
Wotton & Kearney: wottonkearney.com.au
WV Technologies: webventuretechnologies.com
Wyda Game: wydagame.com
XY Sense: xysense.com
Year 13: yearup.org
Yooralla: yooralla.com.au
YourDC: yourdc.com.au
yourtown: yourtown.com.au
Zenphi: zenphi.com
Zipform: zipformpackaging.com.au
Zetta Group Limited: zettagroup.cn
Zudello: zudello.com
Zitcha: zitcha.com
Zudello: zudello.com
